+-+-+-+-+-+-+-+-+-+-+
|   | |       |     |
+-+ + +-+ +-+-+-+-+ +
| |       |       | |
+ + +-+-+-+-+ +-+-+ +
|     |   | |       |
+ +-+-+-+ + + + +-+-+
|   | |   |   |   | |
+ +-+ + +-+ +-+-+-+ +
| |   |         | | |
+ + +-+-+-+-+ +-+ + +
| | |     |   |   | |
+ + + + +-+-+ + +-+ +
|   | |         |   |
+ +-+-+ + + +-+-+-+ +
|       | | | |   | |
+-+ + +-+ +-+ + +-+ +
| | | | |     |     |
+ +-+ + +-+-+ +-+ +-+
|           |       |
+-+-+-+-+-+-+-+-+-+-+
