+-+-+-+-+-+-+-+-+-+-+-+-+-+-+-+-+-+-+-+-+
| | |         | | |   | |           | | |
+ + + + +-+ +-+ + +-+ + + +-+ + + +-+ + +
|   | | |   | |       | |   | | | | |   |
+-+ +-+ +-+-+ + + + +-+ + +-+ +-+-+ + +-+
| |     |   |   | |   | |   | | |       |
+ +-+-+ + +-+ + +-+-+-+ +-+-+ + +-+-+ +-+
| | |   | |   |   |   |   |             |
+ + + +-+ +-+ + +-+-+ + +-+-+-+-+ + +-+-+
| |     | | | |   |         | | | | | | |
+ +-+-+ + + +-+-+ +-+-+ + +-+ + +-+ + + +
| | | |             | | |         |   | |
+ + + + +-+ +-+-+-+-+ + + +-+-+ +-+-+ + +
|         |   |     |   | | |   | |     |
+-+-+ +-+-+-+-+ +-+-+-+ +-+ + +-+ +-+ +-+
| | |   | |             | | | |   | | | |
+ + +-+ + + + + +-+ +-+-+ + + +-+ + + + +
|   |   |   | | | |   |     |     |   | |
+ +-+-+ +-+ + +-+ +-+ +-+ +-+-+-+ + +-+ +
|   | |     | | | |   | | | | |   |     |
+-+ + +-+ + +-+ + +-+ + + + + + +-+-+ +-+
| | | | | | | |         | | |       | | |
+ + + + + +-+ + +-+ + +-+ + + +-+ +-+ + +
| |   |       | |   | | | | | | |   | | |
+ +-+ +-+-+ + +-+ + +-+ + + + + + +-+ + +
|       | | | |   |   |     |   |       |
+-+-+-+ + +-+ + +-+-+-+ +-+-+ +-+-+ +-+-+
| | | |     | |       |   | |   | |   | |
+ + + +-+-+ +-+-+ +-+-+-+ + +-+ + +-+ + +
|     | | |   |             | |   | | | |
+ +-+-+ + + +-+-+-+ +-+-+-+-+ + +-+ + + +
| |   | | |   |   | |   | | |   |       |
+ +-+ + + +-+ + +-+ +-+ + + + + + + +-+-+
| | | |   |       | |       | | | |   | |
+ + + + +-+ + + +-+ + + +-+-+-+-+ +-+-+ +
| |   |     | |   |   | |       | |   | |
+ +-+ +-+-+-+-+-+ +-+-+ +-+ +-+-+ +-+ + +
| | |               |     | |           |
+ + + + +-+-+-+-+ +-+-+ +-+ + + +-+-+-+-+
|     |         |           | |         |
+-+-+-+-+-+-+-+-+-+-+-+-+-+-+-+-+-+-+-+-+
