+-+-+-+-+-+
| |     | |
+ +-+-+ + +
| | | |   |
+ + + +-+ +
|   | | | |
+-+ + + + +
|       | |
+ +-+ +-+ +
|   |     |
+-+-+-+-+-+
